############
#...#......#
..#.#.####.#
###.#....#.#
#....###.#..
####.#.#.#.#
#..#.#.#.#.#
##.#.#.#.#.#
#........#.#
######.###.#
#......#...#
############

############
..#######..#
#..#...#..##
#.##....##..
#....##....#
#..######.##
##.#####...#
#........#.#
#.######.#.#
#.#..###.#.#
#..........#
############